3 3 3 3 3 3 3 3 3 3 3 3 3 3 3 3 3 3 3 3
3 4 4 4 4 4 4 4 4 4 4 4 4 4 4 4 4 4 4 3
3 4 4 4 4 4 4 4 4 5 5 4 4 4 4 4 4 4 4 3
3 4 5 5 5 5 5 5 5 3 3 5 5 5 5 5 5 5 4 3
3 4 4 4 4 4 4 4 4 3 3 4 4 4 4 4 4 4 4 3
3 5 5 5 5 5 5 5 4 3 3 4 5 5 5 5 5 5 5 3
3 4 4 4 4 4 4 4 4 3 3 4 4 4 4 4 4 4 4 3
3 4 5 5 5 5 5 5 5 3 3 5 5 5 5 5 5 5 4 3
3 4 4 4 4 4 4 4 4 3 3 4 4 4 4 4 4 4 4 3
3 5 5 5 5 5 5 5 4 3 3 4 5 5 5 5 5 5 5 3
3 4 6 4 4 4 4 4 4 3 3 4 4 4 4 4 4 7 4 3
3 3 3 3 3 3 3 3 3 3 3 3 3 3 3 3 3 3 3 3